1 13 31
###############################
#p  x     *  1 *   *  * * *   #
# # # #*# # #*#*# # # #*#*#*# #
#   *    b* *  *      *   * * #
# # # # # #*# # #*#*# # # # #*#
#f   t   l  *  *  *   1     * #
# # # # # # # # # #*# #*# #*# #
#*  *   1   *  *      *       #
# # # # #*# # # # #*# # # # #*#
#*     **  *       *     *   *#
# #*# # # # # # #*# # #*# # # #
#       *  *  *   *  *    *  *#
###############################