1 13 31
###############################
#p s*   * * *  *  1 *  * * *  #
# # # #*# # #*#*# # # #*# #*# #
#*  *  *    f* *    2 *   * * #
# # # # # #*# # #*#*# # # # # #
#x   * * t *  **  *     l     #
# # # # # # # # # #*# #*# # # #
#*  * b    *   *      *       #
# # # # #*# # # #*# # # # # # #
#*    **  *       *      2    #
# #*# # # # # # #*# # # # # # #
#   3    * *  *   *  *   *    #
###############################