1 13 31
###############################
#p    *   *           *  *  x #
# #*# # # # # # # # # #*# #*# #
#*  t     *       * * 2  *    #
# # #*# # # #*#*# #*# # # # # #
#  *   **      *l      **     #
# # # # # # # # # # # # # # # #
#  *  *  *b  *  * t  *  3   * #
#*#*# #*# # # # # # # # # # # #
#          *   *  * f ** *   *#
# # # #*# # # # # # #*# # # # #
#   2   x     *  *  * *       #
###############################